111111111111111111111
100000000010000000001
100000000010000000001
100000000010000000001
100000000000000000001
100000000000000000001
100000000000000000001
100000000010000000001
100000000010000000001
100000000010000000001
111100011111110001111
100000000010000000001
100000000010000000001
100000000010000000001
100000000000000000001
100000000000000000001
100000000000000000001
100000000010000000001
100000000010000000001
100000000010000000001
111111111111111111111